moonswift                                                                       
+----------------++------------------------------------------------------------+
|(empty)         ||No project file found.                                      |
|                ||Press <i> to create moonswift.toml, or open a .lua file dire|
|                ||                                                            |
|                ||                                                            |
|                ||                                                            |
|                ||                                                            |
|                ||                                                            |
|                ||                                                            |
|                ||                                                            |
|                ||                                                            |
|                ||                                                            |
|                ||                                                            |
+----------------++------------------------------------------------------------+
+------------------------------------------------------------------------------+
|[ Output ] [ Diagnostics ]                                                    |
|                                                                              |
|                                                                              |
|                                                                              |
|                                                                              |
|                                                                              |
+------------------------------------------------------------------------------+
                                                                j/k  Enter  m  /

=== styles ===