moonswift                                                                                           
+----------------------------++--------------------------------------------------------------------+
|(empty)                     ||No project file found.                                              |
|                            ||Press <i> to create moonswift.toml, or open a .lua file directly.   |
|                            ||                                                                    |
|                            ||                                                                    |
|                            ||                                                                    |
|                            ||                                                                    |
|                            ||                                                                    |
|                            ||                                                                    |
|                            ||                                                                    |
|                            ||                                                                    |
|                            ||                                                                    |
|                            ||                                                                    |
|                            ||                                                                    |
|                            ||                                                                    |
|                            ||                                                                    |
|                            ||                                                                    |
|                            ||                                                                    |
|                            ||                                                                    |
|                            ||                                                                    |
|                            ||                                                                    |
|                            ||                                                                    |
|                            ||                                                                    |
|                            ||                                                                    |
+----------------------------++--------------------------------------------------------------------+
+--------------------------------------------------------------------------------------------------+
|[ Output ] [ Diagnostics ]                                                                        |
|                                                                                                  |
|                                                                                                  |
|                                                                                                  |
|                                                                                                  |
|                                                                                                  |
|                                                                                                  |
|                                                                                                  |
|                                                                                                  |
|                                                                                                  |
|                                                                                                  |
+--------------------------------------------------------------------------------------------------+
                                                        j/k navigate  Enter load  m picker  / filter

=== styles ===